#Nivel basico
_________
_+@@@@@+_
_@.....@_
_@.....@_
_@.....@_
_@.....@_
_@.....@_
_+@@@@@+_
_________
