#Nivel basico
__________  __________ 
_+@@@@@@+_  _+@@@@@@+_
_@......@_  _@......@_
_@......@_  _@......@_
_@..................@_
_@..................@_
_@......@_  _@......@_
_@......@_  _@......@_
_+@@@@@@+_  _+@@@@@@+_
__________  __________
