#Nivel basico
__________ 
_+@@@@@@+_
_@......@_
_@......@_ 
_@......@_
_@......@_
_@......@_
_@......@_
_+@@@@@@+_
__________
